1111111111111111
1111111111101111
1111111111101111
111111111A000111
1111111110000111
1111111100000111
1111110000001111
1111000000011111
1111000000011111
1111000000011111
1111000000011111
1111000P00111111
1111000000111111
1111000001111111
1110000001111111
1110000001111111
1110000011111111
1110000011111111
1111000111111111
1111111111111111
