1111111111111111
1111111111111111
1111111111101111
11111111110A1111
1111111110001111
1111111100011111
1111110B00011111
1111100000011111
1111000000C11111
1111000000011111
1111100D00111111
1111100P00111111
1111100000111111
1111000001111111
1110000E01111111
1110000001111111
1111F00011111111
1111000011111111
1111000111111111
1111111111111111
